{
    "row":9,
    "col":9,
    "blockCount":4,
    "cells":[
                1,1,1,1,1,1,1,1,1,
                1,1,1,1,1,1,1,1,1,
                1,1,1,1,1,1,1,1,1,
                1,1,1,1,1,1,1,1,1,
                1,1,1,1,1,1,1,1,1,
                1,1,1,1,1,1,1,1,1,
                1,1,1,1,1,1,1,1,1,
                1,1,1,1,1,1,1,1,1,
                1,1,1,1,1,1,1,1,1
             ]
}
